%%%%%%%%%
%  .    %
% %%%%% %
%  G    %
%G%%%%% %
%P      %
% %%%%% %
%       %
%%%%%%%%%