%%%%%%%%%%
% G      %
%P       %
%        %
%        %
%        %
%        %
%    .   %
%        %
%%%%%%%%%%