%%%%%
% G %
%P .%
%%%%%
%%%%%
