%%%%%%%%%%
% G      %
%P       %
%  GG    %
%   GG   %
%        %
%   GG   %
%  GG  . %
%      G %
%%%%%%%%%%