%%%%%%
% G  %
%P.  %
%    %
%    %
%%%%%%
