%%%%%
%.G.%
%P..%
%...%
%%%%%
