%%%%%%
% G  %
%P.  %
% G  %
%    %
%%%%%%
