%%%%%%%%
%P     %
%  %   %
%  %   %
%  %.  %
%     G%
%%%%%%%%