%%%%%%%%%%%%%%%%%%%
%%%%%%%%%%%%%%%%%%%
%%%%%%%%%%%%%%%%%%%
%%%%%%%%%%%%%%%%%%%
%%%%%%%%%%%%%%%%%%%
%    %       %    %
% %% % %%%%% % %% %
% %      P      % %
% % %% %% %% %% % %
%      %GGG%      %
% % %% %% %% %% % %
% %       .     % %
% %% % %%%%% % %% %
%    %       %    %
%%%%%%%%%%%%%%%%%%%
%%%%%%%%%%%%%%%%%%%
%%%%%%%%%%%%%%%%%%%
%%%%%%%%%%%%%%%%%%%
%%%%%%%%%%%%%%%%%%%