%%%%%%%%%%%
%%%%%%%%%%%
%.....P...%
%.%.%.%.%.%
%.%.%.%.%.%
%.%..G..%.%
%.%.%.%.%.%
%.%.%.%.%.%
%.....G...%
%%%%%%%%%%%
%%%%%%%%%%%