%%%%%%%%%%%%%%%
%%%%   %   %%%%
%%%%   %  .%%%%
%    %   %    %
% %% %% %% %% %
% %   GGG   % %
% %% %%%%% %% %
%P   GGGGG    %
% %% %%%%% %% %
% %   GGG   % %
% %% %% %% %% %
%    %   %    %
%%%%   %   %%%%
%%%%   %   %%%%
%%%%%%%%%%%%%%%