%%%%%%%%%%%%%%%
%%%%...%...%%%%
%%%%...%...%%%%
%....%...%....%
%.%%.%%.%%.%%.%
%.%...GGG...%.%
%.%%.%%%%%.%%.%
%P...GGGGG....%
%.%%.%%%%%.%%.%
%.%...GGG...%.%
%.%%.%%.%%.%%.%
%....%...%....%
%%%%...%...%%%%
%%%%...%...%%%%
%%%%%%%%%%%%%%%