%%%%%%%%%
%       %
% % % % %
% %%%%% %
%G  %  .%
% %%%%%P%
% % % % %
%  G    %
%%%%%%%%%