%%%%%%%
%.....%
%.%%%.%
%.%%%G%
%.%%%.%
%P....%
%%%%%%%