%%%%%%%%
%      %
% %%%% %
%G %  .%
%.%%%%P%
%      %
%%%%%%%%