GGGGGGGG
G......G
G.GGGG.G
G..G...G
G.GGGG.G
GP.....G
GGGGGGGG