%%%%%%%%%%%%%%%
%%%%...%...%%%%
%%%%...%...%%%%
%....%...%....%
%.%%.%%.%%.%%.%
%.%.........%.%
%.%%.%%%%%.%%.%
%P....GG......%
%.%%.%%%%%.%%.%
%.%.........%.%
%.%%.%%.%%.%%.%
%....%...%....%
%%%%...%...%%%%
%%%%...%...%%%%
%%%%%%%%%%%%%%%