%%%%%%%%
%      %
% %%%% %
%G %  .%
% %%%%P%
%      %
%%%%%%%%